WWWWWWWWWWWWWWWWWWWWWWWWWWWWWWWWWWWWWWWWWWWWWWWWWWWWWWWWWWWWWWWWWWWWWWWWWWWWWWWWWWWWWWWWWWWWWWWWWWWWWWWWWWWWWWWWWWWWWWWWWWWWWWWWWWWWWWWWWWWWWWWWWWWWWWWWWWWWWWWWWWWWWWWWWWWWWWWWWWW
W                    W                                                                                                                                                            W
W                    W                                                                                                                                                            W
W                    W                                                                                                                                                            W
W                    D                                                                                                                                                            W
W                    W                                                                                                                                                            W
W                    W                                                                                                                                                            W
W                    w                                                                                                                                                            W
W                    W                                                                                                                                                            W
W                    W                                                                                                                                                            W
W                    W                                                                                                                                                            W
W                    W                                                                                                                                                            W
W                    W                                                                                                                                                            W
W                    W                                                                                                                                                            W
W         E          W                                                                                                                                                            W
W                    W                                                                                                                                                            W
W                    W                                                                                                                                                            W
W                    W                                                                                                                                                            W
W                    W                                                                                                                                                            W
W                    W                                                                                                                                                            W
W                    W                                                                                                                                                            W
W                    W                                                                                                                                                            W
W                    W                                                                                                                                                            W
W                    W                                                                                                                                                            W
W                    W                                                                                                                                                            W
W                    W                                                                                                                                                            W
W         S          W                                                                                                                                                            W
W                    W                                                                                                                                                            W
W                    W                                                                                                                                                            W
WWWWWWWWWWDWWWWWWWWWWW                                                                                                                                                            W
W                    W                                                                                                                                                            W
W                K   W                                                                                                                                                            W
W                    W                                                                                                                                                            W
W                    W                                                                                                                                                            W
W         P          W                                                                                                                                                            W
W                    W                                                                                                                                                            W
W                    W                                                                                                                                                            W
W                    W                                                                                                                                                            W
WWWWWWWWWWWWWWWWWWWWWWWWWWWWWWWWWWWWWWWWWWWWWWWWWWWWWWWWWWWWWWWWWWWWWWWWWWWWWWWWWWWWWWWWWWWWWWWWWWWWWWWWWWWWWWWWWWWWWWWWWWWWWWWWWWWWWWWWWWWWWWWWWWWWWWWWWWWWWWWWWWWWWWWWWWWWWWWWWWW
